111111111111111111111111111111
1P1000000000000000000000000001
101000000000000000000000000001
100010000000000000000000000001
111110000000000000000000000001
100000000000000000000100000001
100000000000000000000000000001
100100000000000000000000000001
100000000000000000000100000001
100000000000000000000000000001
100000000000000000000000000001
1000000000000000C0000000000001
100000000000000000000000000001
100000000000000000000000000001
1000000000000000000000000000E1
111111111111111111111111111111
