111111111
101000001
1P100C0E1
101C00001
100000001
1000C0001
111111111
