111111101
100C00001
1P000V0E1
100C00001
100000001
100000C01
111111111
