111111111
100000001
1P000C0E1
100C00001
100000001
1000C0001
111111111
