111111101
100C00001
1P000V0E1
100C00001
111111111
