111111111
100C00001
1P00000E1
100C00001
100000001
100000C01
111111111
