1111111111111111111111111111111111
100000000000000C00000C000000000001
1010010100100000101001000000010101
1010010010101010001001000000010101
10000000C00C000000000C0000C00000C1
10000000C00C000000000C0000C00000C1
10000000C00C000000000C0000C00000C1
10000000C00C0000E0P00C0000C00000C1
10000000C00C000000000C0000C00000C1
10000000C00C000000000C0000C00000C1
10000000C00C000000000C0000C00000C1
10000000C00C000000000C0000C00000C1
10000000C00C000000000C0000C00000C1
1111111111111111111111111111111111
