11111111111111111
1000P0000E00000C1
11111111111111111
