1111111111111111111111
10P0000000000000000001
10C0C0C0C0C0C0C0C0C0C1
1C0C0C0C0C0C0C0C0C0111
10000000001000000000E1
1111111111111111111111
1111111111111111111111
1111111111111111111111
1111111111111111111111
1111111111111111111111
1111111111111111111111
1111111111111111111111
1111111111111111111111
1111111111111111111111
1111111111111111111111
