1111111111111111111111111111111111111111111111111111111
100000I000000000000000000000000000000000000000000000001
100000000000000000000000000I00000000000000000I000000001
1000000000000000000000000000000000000000000000000000001
100000000000000000000000E000000000000000000000000000001
1000000000000000000000000000000000000000C000000C0000001
100000I0000000000000000000I0000000000000000000000000001
1P00000000000000000000000000000000000000000000000000001
1111111111111111111111111111111111111111111111111111111
