11111
1E0I1
10001
1P0C1
11111
