111111
1I00C1
100111
1PE111
111111
