11111111
10000E01
10P00I01
11100010
1C010E01
11111111
