11111111
10000E01
10P00001
1110I010
1C010P01
11111111
