11111111
10000001
10P00I01
11100010
1C010E01
11111111
