11111111
10000E01
10000I01
11100010
1C010E01
11111111
